INTROSENSEI1	...Именно так ты и становишься великим бойцом.
INTROSENSEI2	Тренировки и тяжелая работа над собой неминуемо приведут тебя к ошеломляющим результатам!
INTROPLAYER1	Но Сенсей, как ты вообще можешь что-либо знать о боях, ты едва держишься на ногах!
INTROSENSEI3	Ох, юнец, я далеко не всегда был старым.
INTROSENSEI4	Было время, когда я был таким же молодым и наивным как ты...
INTROFIGHTSENSEI1	Мой последний бой, это было нечто.
INTROFIGHTSENSEI2	Следуя наставлениям моего учителя, я оставался предельно сконцентрированным на протяжении всего боя.
INTROFIGHTSENSEI3	Я видел своего соперника насквозь и знал все его слабые места.
INTROFIGHTSENSEI4	Я был быстр, как дикий зверь.
INTROFIGHTSENSEI5	Он не мог предугадать мои надвигающиеся атаки и даже на секунду мне показалось, что это будет легкая победа
INTROFIGHTSENSEI6	Мои движения были идеальны, я мысленно был готов к победе, но случилось непредвиденное...
INTROFIGHTSENSEI7	В момент, когда я был в миллиметре от победы, моё колено сломалось, разрушив все мои шансы победить.
INTROENDPLAYER1	Я бы был в ярости, сказал бы тому парню, что ему просто повезло, и что я обязательно выиграю его в следующий раз, когда он снова мне попадется!
INTROENDPLAYER2	А еще бы добавил, что его мамка...
INTROENDSENSEI1	Нет-нет-нет, мой юный ученик. Поражения учат тебя не меньше, чем победы.
INTROENDPLAYER3	Поэтому ты до сих пор используешь трость? Твоя нога...она до сих пор болит?
INTROENDSENSEI2	Ээ, нет. На самом деле, ты полностью восстанавливаешься после каждого боя.
INTROENDSENSEI3	Просто...эм, я выгляжу круче с тростью
INTROENDSENSEI4	ээ, зачем ты вообще об этом спрашиваешь?... Какая разница! Мы уже слишком долго бездельничаем!
INTROENDSENSEI5	Если ты хочешь стать действительно хорошим бойцом, тебе нужно тренироваться; А не сидеть на скамейке всё время!
#	
#HINT MESSAGES	
CAMERAHINT1	Двигай камерой, используя клавиши ~W~ ~A~ ~S~ ~D~
CAMERAHINT2	Чтобы изменить высоту положения камеры, удерживай клавишу ~SHIFT~
CAMERAHINT3	Также можно контролировать положение камеры, кликая правой кнопкой мыши в любую точку.
CONTROLSHINT1	В Toribash ты контролируешь своего бойца, изменяя положение его мышц - джоинтов.
CONTROLSHINT2	Существует четыре положения джоинта: ХОЛД, РЕЛАКС, СГИБАНИЕ и РАЗГИБАНИЕ. Их комбинирование позволяет совершать неповторимые приёмы, что делает каждый бой уникальным.
CONTROLSHINT3	Кликни на колено сенсея и разогни его, чтобы пнуть оппонента.
CONTROLSHINT4	Также для более быстрого переключения джоинтов можно использовать горячие клавиши.
CONTROLSHINT5	Чтобы одновременно НАПРЯЧЬ или РАССЛАБИТЬ все джоинты, нажми клавишу ~C~
CONTROLSHINT6	Наведи мышку на любой джоинт и нажми ~X~, это позволит НАПРЯЧЬ или РАССЛАБИТЬ его
CONTROLSHINT7	Чтобы РАЗОГНУТЬ или СОГНУТЬ джоинт, наведи на него курсор и используй клавишу ~Z~
QIHINT1	Твой опыт в мире Toribash оценивается через Qi. За каждый проведенный бой ты получаешь 1 Qi
QIHINT2	Чем больше у тебя Qi, тем выше твой пояс и тем больше вещей для кастомизации твоего бойца будет доступно в магазине.
