#PLAYER MESSAGES	
INTROSENSEI1	Сейчас я научу тебя, как побеждать соперника, используя только свои руки.
INTROSENSEI2	Давай попробуем провести самую простую атаку - она называется "нубклап".
INTROSENSEI3	Вот как это выглядит.
SENSEINOOBCLAP1	Я просто вытягиваю свои руки вперед и тем самым наношу урон, либо встаю в удобную для захвата позицию...
SENSEINOOBCLAP2	...или готовлюсь блокировать удары противника!
SENSEINOOBCLAP3	Не смущайся незвания этого движения, ведь нубклап - это очень полезный приём, который иногда используют даже лучшие игроки!
SENSEINOOBCLAP4	Очень хорошо! Переходим к следующему заданию!
SENSEIPUNCH1	Для действительно мощных ударов недостаточно использовать только грудные мышцы.
SENSEIPUNCH2	Посмотри на этот удар.
SENSEIPUNCH3	Я использовал торс и локти для большей мощности удара.
SENSEIPUNCH4	Чем сильнее ты бьешь своего оппонента, тем больше очков ты получаешь и тем ближе оказываешься к победе.
SENSEIPUNCHOPTINCOMPLETE	Неплохо. Конечно, можно было бы его немного усовершенствовать, но удар есть удар - хорошая работа!
SENSEIPUNCHOPTCOMPLETE	Превосходно! Именно так, как я показывал!
SENSEIPUNCH5	Теперь перейдем к сегодняшнему финальному тесту!
SENSEIFINAL1	Время для свободной тренировки ударов, мой ученик!
SENSEIFINAL2	Бей грушу до тех пор, пока не наберется 100000 очков!
SENSEIFINAL3	Обращай внимание на таймер, ведь тебе нужно выполнить задание до истечения 500 фреймов!
SENSEIFINALTIMEUP	Ох, похоже, что время вышло. Ничего страшного, попробуй еще раз!
SENSEIFINALRESTART	Окей, вспомни приёмы, которые я показывал ранее, и попробуй теперь набрать 100000 очков!
SENSEIFINALOPTINCOMPLETE	Отлично! Хорошо потренировались!
SENSEIFINALOPTCOMPLETE	Вау, это было что-то! Отличная работа!
SENSEIFINAL4	Теперь ты знаешь, как использовать свои руки, и готов к тренировке ног!
#	
#HINT MESSAGES	
NOOBCLAPHINT1	Нажми ~C~, чтобы напрячь все джоинты и не упасть.
NOOBCLAPHINT2	Чтобы ВЫТЯНУТЬ РУКИ вперёд или назад, необходимо изменять положение твоих ГРУДНЫХ МЫШЦ.
NOOBCLAPHINT3	СОГНИ обе грудные мышцы, чтобы вытянуть руки ПЕРЕД СОБОЙ.\nПомни, для изменения положения джоинтов можно использовать мышь или клавишу ~Z~
NOOBCLAPHINT4	Хорошо, но это пока не всё.\nЧтобы ЗАВЕРШИТЬ ХОД и увидеть результат, нажми ~ПРОБЕЛ~
PUNCHHINT1	Напряги все джоинты, нажав ~C~
PUNCHHINT2	Чтобы занять стартовую позицию, СОГНИ локти и РАССЛАБЬ плечи.
PUNCHHINT3	ПЛЕЧИ помогают тебе поднимать или опускать руки.\nЛОКТИ позволяют сгибать их.
PUNCHHINT4	Чтобы закончить ход, нажми ~ПРОБЕЛ~
PUNCHHINT5	ПОВЕРНИ ГРУДНУЮ КЛЕТКУ влево, чтобы сделать удар мощнее.
PUNCHHINT6	Теперь согни внутрь ПРАВУЮ ГРУДНУЮ МЫШЦУ и разогни ПРАВЫЙ ЛОКОТЬ чтобы ударить грушу.
PUNCHHINT7	Не стесняйся импровизировать и всегда обращай внимание на призрак!\nНаращивание скорости - ключевой момент при совершении мощных ударов.
PUNCHHINT8	Нажми ~ПРОБЕЛ~, когда будешь готов закончить движение.
#	
#TASK MESSAGES	
NOOBCLAPTASK	Ударь грушу с помощью нубклапа
PUNCHTASK	Повтори удар, которому тебя научил Сенсей
PUNCHTASKOPT	Подними правое плечо и разогни запястье, чтобы улучшить удар
FINALTASK	Заверши урок Сенсея по ударной технике
FINALTASKMAIN	Набери 100000 очков урона, чтобы завершить задание
FINALTASKOPT	Набери больше 500000 очков, чтобы получить бонусную награду
