#PLAYER MESSAGES	
INTROSENSEI1	... وهذه هي الطريقة التي تصبح بها مقاتلا كبيرا.
INTROSENSEI2	من خلال التدريب والعمل الشاق ، يمكنك تحقيق نتائج مذهلة حقا!
INTROPLAYER1	لكن Sensei، كيف يمكنك معرفة أي شيء عن القتال - يمكنك بالكاد المشي بنفسك!
INTROSENSEI3	هاه ، شاب ، لم أكن دومًا كبيرًا.
INTROSENSEI4	كان هناك وقت ، ليس منذ فترة طويلة ، عندما كنت صغيرا وساذجا كما أنت الآن ...
INTROFIGHTSENSEI1	معركتي الأخيرة ، كانت كبيرة.
INTROFIGHTSENSEI2	بعد توجيه سيدتي ، بقيت مركزة خلال المعركة بأكملها.
INTROFIGHTSENSEI3	راقبت نقاط ضعف منافسي - ورأيت كل واحد منهم.
INTROFIGHTSENSEI4	كنت سريعا مثل الحيوانات البرية.
INTROFIGHTSENSEI5	لم يستطع رؤية هجماتي القادمة ، وبدا الأمر وكأنه فوز سهل.
INTROFIGHTSENSEI6	كانت تحرّكاتي مثالية وكنت سأفوز ، لكن حدث شيء غير متوقع على الإطلاق ...
INTROFIGHTSENSEI7	تماما كما كنت على وشك هزيمة منافسي ، كسرت ركبتي ، مما أفسد فرصي.
INTROENDPLAYER1	سأشعر بالغضب وأدعو ذلك الرجل بالمحظوظ ، ثم أخبره أنني سأضربه في المرة القادمة التي أواجهه!
INTROENDPLAYER2	وأود أيضا أن أقول له أن أمه هي
INTROENDSENSEI1	لا ، لا ، طالبي الصغير هزائمك تعلمك أكثر من الدرس الذي تحققه انتصاراتك.
INTROENDPLAYER3	فهل هذا هو السبب في أنك تستخدم عصا ، سيد؟ ساقك ، هل ما زال تؤلمك؟
INTROENDSENSEI2	أوه ، لا ، لقد شفىنا في الواقع بعد كل قتال.
INTROENDSENSEI3	هذا فقط ، أنا أه ، أنا أبدو أكثر محترمة بعصا
INTROENDSENSEI4	إيه ! ، لماذا تسأل حتى؟ ... لا يهم! كنا نتجنب العمل لمدة طويلة الآن!
INTROENDSENSEI5	إذا كنت تريد أن تصبح مقاتلًا جيدًا حقًا ، فأنت بحاجة إلى التدريب ؛ لا تجلس على مقاعد البدلاء في كل وقت!
#	
#HINT MESSAGES	
CAMERAHINT1	قم بتحريك الكاميرا باستخدام ~ W ~ ~ A ~ ~ S ~ ~ D ~ .
CAMERAHINT2	لضبط ارتفاع الكاميرا ، استمر في ضغط ~ SHIFT أثناء تحريك الكاميرا.
CAMERAHINT3	يمكنك أيضًا التحكم في الكاميرا عن طريق النقر على الزر الأيمن للفأرة في أي مكان.
CONTROLSHINT1	في Toribash ، يمكنك التحكم في شخصيتك عن طريق تعديل الحالات المشتركة على جسمه.
CONTROLSHINT2	هناك أربع مفاصل مشتركة - التعليق والاسترخاء والتعاقد والتمدد. يؤدي وضعها إلى تحركات فريدة تجعل كل معركة خاصة.
CONTROLSHINT3	انقر على الركبة Sensei لتغيير حالتها إلى تمديد وركل الخصم.
CONTROLSHINT4	يمكنك أيضًا التحكم في المفاصل بشكل أسرع عن طريق استخدام مفاتيح الاختصار بلوحة المفاتيح.
CONTROLSHINT5	لتغيير جميع حالات المفاصل في الحال التعليق أو الاسترخاء ، اضغط على ~ C ~
CONTROLSHINT6	حرك فوق أي مفصل واضغط ~ X ~ للتبديل بين حالات التعليق والاسترخاء.
CONTROLSHINT7	للتبديل بين حالات التعاقد والتمدد ، اضغط على ~ Z ~ بينما تحوم فوق وصلة.
QIHINT1	يتم قياس تجربة Toribash في QI. لكل معركة تلعبها ، تحصل على 1 QI.
QIHINT2	كلما حصلت على Qi ، أصبح الحزام الأفضل الذي تتلقاه والمزيد من عناصر التخصيص متاحة للشراء.
